000000000000000000000000000000
000000000000000000000000000000
000000000000000000000000000000
000000022222000000000000000220
000000000000000000000000000000
000000000000000000000000000000
220000000000000002200000022000
112222222222222221100002211200
111111111111111111100001111100
111111111111111111100010111000
111111111111111111100000100000
111111111111111111100010100000
111111111111111111100000000000
